6 12
++++X+++++++
++   +  ++ +
+  + ++ +  M
+ +++   + ++
+  +  +    +
++   +++++++